##############################
# @                          #
#                            #
#                            #
#       $                    #
#                            #
#                            #
#                            #
#                            #
#                     $      #
#            $               #
#                            #
#                            #
#                            #
#   ...  #####################
#        #
##########

#    #  #
#    #  #
######  #
#    #  #
#    #  #
