                ####  ####
               ##  ####  ##
               #          #
               #  ##  ##  ###
   #### ######### #####  #  ######### #######
####  ###  #  ##  #  ##      ##  #  ###  #  ##
#      #       #      ##  #  #       #       #
#   #  #  ###  ##  #  ##### ##  ###  #  ###  ###
####  ###  #  #  ##  #  ##  ###  #  ###  #  #  ##
   #       #      #      #       #       #      #
   ##  #  ###  #  ##  #  ##  #  ###  #  ###  #  #
    ####### #### ###### ######### ####### #### ##
   ##  #  ###  #  ##  #  ##  #  ###  #  ###  #  #
   #       #      #      #       #       #      #
 ###  ###  #  #  ##  #  ##  ###  #  ###  #  #  ##
##  #  #  ###  ##  #  ##  #  #  ###  #  ###  ###
#      #       #      #      #       #       #
#  #  ###  #  ##  #  ##  #  ###  #  ###  #  ##
## #### ######### ###### #### ####### #######
#  #  ###  #  ##  #  ##  #  ###  #  ###  #  ##
#      #       #      #      #       #       #
##  #  #  ###  ##  #  ##  #  #  ###  #  ###  ###
 ###  ###  #  #  ##  #  ##  ###  #  ###  #  #  ##
   #       #      #      #       #       #      #
   ##  #  ###  #  ##  #  ##  #  ###  #  ###  #  #
    ####### #### ###### ######### ####### #### ##
   ##  #  ###  #  ##  #  ##  #  ###  #  ###  #  #
   #       #      #      #       #       #      #
 ###  ###  #  #  ##  #  ##  ###  #  ###  #  #  ##
##  #  #  ###  ##  #  ##  #  #  ###  #  ###  ###
#      #       #      #      #       #       #
#  #  ###  #  ##  #  ##  #  ###  #  ###  #  ##
## #### ######### ###### #### ####### #######
#  #  ###  #  ##  #  ##  #  ###  #  ###  #  ##
#      #       #      #      #       #       #
##  #  #  ###  ##  #  ##  #  #  ###  #  ###  ####
 ###  ###  #  #  ##  #  ##  ###  #  ###  #  # @ #
   #       #      #      #       #       #   $ .#
   ##  #  ###  #  ##  #  ##  #  ###  #  ###  ####
    ####### #### ###### ######### ####### ####
              #  ##  ##  #
              #          #
              ##  ####  ##
               ####  ####
